Date,New Cases,Total Cases,Recovered,Deaths,Active Cases
06/03/2020,1,1,0,0,1
07/03/2020,2,3,0,0,3
08/03/2020,0,3,0,0,3
09/03/2020,1,4,0,0,4
10/03/2020,1,5,0,0,5
11/03/2020,2,7,0,0,7
12/03/2020,5,12,0,0,12
13/03/2020,1,13,1,0,12
14/03/2020,5,18,1,0,17
15/03/2020,3,21,2,0,19
16/03/2020,9,30,2,0,28
17/03/2020,8,38,2,0,36
18/03/2020,10,48,2,0,46
19/03/2020,5,53,2,0,51
20/03/2020,11,64,2,0,62
21/03/2020,9,73,2,0,71
22/03/2020,17,90,2,0,88
23/03/2020,17,107,2,0,105
24/03/2020,3,110,2,0,108
25/03/2020,19,129,2,0,127
26/03/2020,5,134,2,0,132
27/03/2020,5,139,2,0,137
28/03/2020,10,149,2,0,147
29/03/2020,2,151,2,0,149
30/03/2020,5,156,2,0,154
31/03/2020,13,169,2,0,167
01/04/2020,19,188,2,0,186
02/04/2020,7,195,2,0,193
03/04/2020,7,202,2,0,200
04/04/2020,11,213,2,0,211
05/04/2020,14,227,5,0,222
06/04/2020,14,241,5,0,236
07/04/2020,52,293,5,0,288
08/04/2020,6,299,16,1,282
09/04/2020,38,337,16,2,319
10/04/2020,13,350,16,2,332
11/04/2020,20,370,16,3,351
12/04/2020,8,378,44,3,331
13/04/2020,6,384,44,3,337
14/04/2020,9,393,44,3,346
15/04/2020,6,399,44,3,352
16/04/2020,13,412,82,3,327
17/04/2020,10,422,91,3,328
18/04/2020,4,426,99,3,324
19/04/2020,1,427,118,3,306
20/04/2020,4,431,126,3,302
21/04/2020,12,443,150,3,290
22/04/2020,1,444,165,3,276
23/04/2020,1,445,204,3,238
24/04/2020,2,447,223,3,221
25/04/2020,1,448,249,4,195
26/04/2020,0,448,282,4,162
27/04/2020,2,450,286,4,160
28/04/2020,8,458,303,4,151
29/04/2020,5,463,339,4,120
30/04/2020,2,465,351,4,110
01/05/2020,2,467,367,4,96
02/05/2020,1,468,379,4,85
03/05/2020,9,477,392,4,81
04/05/2020,3,480,399,4,77
05/05/2020,2,482,403,5,74
06/05/2020,2,484,407,5,72
07/05/2020,2,486,413,5,68
08/05/2020,3,489,419,5,65
09/05/2020,1,490,427,5,58
10/05/2020,6,496,433,5,58
11/05/2020,7,503,434,5,64
12/05/2020,3,506,434,5,67
13/05/2020,2,508,436,6,66
14/05/2020,14,522,443,6,73
15/05/2020,10,532,448,6,78
16/05/2020,14,546,450,6,90
17/05/2020,7,553,454,6,93
18/05/2020,5,558,456,6,96
19/05/2020,11,569,460,6,103
20/05/2020,15,584,465,6,113
21/05/2020,15,599,468,6,125
22/05/2020,1,600,469,6,125
23/05/2020,9,609,473,6,130
24/05/2020,1,610,476,6,128
25/05/2020,1,611,485,6,120
26/05/2020,0,611,485,6,120
27/05/2020,1,612,491,7,114
28/05/2020,4,616,501,7,108
29/05/2020,0,616,514,8,94
30/05/2020,2,618,525,9,84
31/05/2020,0,618,534,9,75
01/06/2020,1,619,537,9,73
02/06/2020,1,620,554,9,57
03/06/2020,2,622,562,9,51
04/06/2020,0,622,574,9,37
05/06/2020,3,625,583,9,33
06/06/2020,2,627,596,9,22
07/06/2020,2,629,596,9,24
08/06/2020,1,630,596,9,25
09/06/2020,2,632,597,9,26
10/06/2020,3,635,597,9,29
11/06/2020,5,640,600,9,31
12/06/2020,5,645,600,9,36
13/06/2020,1,646,601,9,36
14/06/2020,3,649,603,9,37
15/06/2020,1,650,603,9,38
16/06/2020,6,656,608,9,39
17/06/2020,6,662,610,9,43
18/06/2020,1,663,610,9,44
19/06/2020,0,663,613,9,41
20/06/2020,1,664,616,9,39
21/06/2020,1,665,616,9,40
22/06/2020,0,665,617,9,39
23/06/2020,0,665,618,9,38
24/06/2020,0,665,624,9,32
25/06/2020,3,668,627,9,32
26/06/2020,2,670,632,9,29
27/06/2020,0,670,635,9,26
28/06/2020,0,670,636,9,25
29/06/2020,0,670,639,9,22
30/06/2020,0,670,640,9,21
01/07/2020,1,671,647,9,15
02/07/2020,0,671,649,9,13
03/07/2020,1,672,650,9,13
04/07/2020,0,672,651,9,12
05/07/2020,0,672,652,9,11
06/07/2020,0,672,652,9,11
07/07/2020,1,673,653,9,11
08/07/2020,0,673,654,9,10
09/07/2020,1,674,656,9,9
10/07/2020,0,674,658,9,7
11/07/2020,0,674,658,9,7
12/07/2020,0,674,660,9,5
13/07/2020,0,674,660,9,5
14/07/2020,0,674,660,9,5
15/07/2020,0,674,661,9,4
16/07/2020,0,674,661,9,4
17/07/2020,0,674,662,9,3
18/07/2020,1,675,662,9,4
19/07/2020,1,676,662,9,5
20/07/2020,1,677,664,9,4
21/07/2020,0,677,664,9,4
22/07/2020,2,679,665,9,5
23/07/2020,1,680,665,9,6
24/07/2020,6,686,665,9,12
25/07/2020,0,686,665,9,12
26/07/2020,14,700,665,9,26
27/07/2020,1,701,665,9,27
28/07/2020,7,708,665,9,34
29/07/2020,12,720,665,9,46
30/07/2020,94,814,665,9,140
31/07/2020,10,824,665,9,150
01/08/2020,21,845,665,9,171
02/08/2020,15,860,666,9,185
03/08/2020,14,874,666,9,199
04/08/2020,16,890,668,9,213
05/08/2020,36,926,668,9,249
06/08/2020,20,946,670,9,267
07/08/2020,49,995,675,9,311
08/08/2020,40,1035,675,9,351
09/08/2020,54,1089,684,9,396
10/08/2020,23,1112,688,9,415
11/08/2020,29,1141,692,9,440
12/08/2020,49,1190,695,9,486
13/08/2020,55,1245,708,9,528
14/08/2020,31,1276,762,9,505
15/08/2020,72,1348,782,9,557
16/08/2020,63,1306,749,9,548
17/08/2020,69,1375,759,9,607
18/08/2020,48,1423,766,9,648
19/08/2020,47,1470,784,9,677
20/08/2020,40,1510,802,9,699
21/08/2020,36,1546,854,10,682
22/08/2020,31,1577,901,10,666
23/08/2020,35,1612,934,10,668
24/08/2020,55,1667,977,10,680
25/08/2020,38,1705,1029,10,666
26/08/2020,46,1751,1077,10,664
27/08/2020,37,1788,1121,10,657
28/08/2020,32,1820,1186,10,624
29/08/2020,27,1847,1244,10,593
30/08/2020,15,1862,1313,11,538
31/08/2020,21,1883,1400,12,471
01/09/2020,26,1909,1453,12,444
02/09/2020,22,1931,1490,13,428
03/09/2020,34,1965,1528,13,424
04/09/2020,19,1984,1565,13,406
05/09/2020,30,2014,1601,14,399
06/09/2020,25,2039,1627,14,398
07/09/2020,37,2076,1690,14,372
08/09/2020,23,2099,1729,14,356
09/09/2020,63,2162,1760,14,388
10/09/2020,42,2204,1803,14,387
11/09/2020,43,2247,1833,15,399
12/09/2020,27,2274,1850,15,409
13/09/2020,78,2352,1872,15,465
14/09/2020,53,2405,1890,16,499
15/09/2020,49,2454,1931,16,507
16/09/2020,106,2560,1953,16,591
17/09/2020,35,2595,1978,16,601
18/09/2020,39,2634,1996,17,621
19/09/2020,65,2699,2017,19,663
20/09/2020,32,2731,2047,20,664
21/09/2020,45,2776,2079,21,676
22/09/2020,38,2814,2113,23,678
23/09/2020,42,2856,2173,25,658
24/09/2020,42,2898,2191,27,680
25/09/2020,31,2929,2261,29,639
26/09/2020,29,2958,2304,31,623
27/09/2020,21,2979,2358,31,590
28/09/2020,27,3006,2399,32,575
29/09/2020,29,3035,2484,34,517
30/09/2020,23,3058,2562,34,462
01/10/2020,37,3095,2605,35,455
02/10/2020,44,3139,2668,37,434
03/10/2020,65,3204,2711,38,455
04/10/2020,66,3270,2758,39,473
05/10/2020,57,3327,2770,39,518
06/10/2020,47,3374,2812,40,522
07/10/2020,68,3442,2865,41,536
08/10/2020,64,3506,2884,41,581
09/10/2020,75,3581,2915,41,625
10/10/2020,100,3681,2937,41,703
11/10/2020,95,3776,2967,41,768
12/10/2020,68,3844,2981,43,820
13/10/2020,93,3937,3012,44,881
14/10/2020,111,4048,3064,44,940
15/10/2020,112,4160,3106,45,1009
16/10/2020,122,4282,3142,45,1095
17/10/2020,204,4486,3184,45,1257
18/10/2020,142,4628,3236,45,1347
19/10/2020,109,4737,3242,45,1450
20/10/2020,134,4871,3282,46,1543
21/10/2020,155,5026,3331,46,1649
22/10/2020,111,5137,3384,49,1704
23/10/2020,121,5258,3439,49,1770
24/10/2020,115,5373,3478,50,1845
25/10/2020,125,5498,3567,51,1880
26/10/2020,80,5578,3630,53,1895
27/10/2020,107,5685,3715,55,1915
28/10/2020,75,5760,3789,56,1915
29/10/2020,106,5866,3880,59,1927
30/10/2020,76,5942,3990,61,1891
31/10/2020,100,6042,4155,62,1825
01/11/2020,140,6182,4286,64,1832
02/11/2020,218,6400,4397,64,1939
03/11/2020,106,6506,4505,64,1937
04/11/2020,84,6590,4672,65,1853
05/11/2020,174,6764,4765,70,1929
06/11/2020,129,6893,4832,73,1988
07/11/2020,146,7039,5000,74,1965
08/11/2020,102,7141,5103,76,1962
09/11/2020,102,7243,5185,78,1980
10/11/2020,153,7396,5274,81,2041
11/11/2020,141,7537,5371,85,2081
12/11/2020,109,7646,5479,88,2079
13/11/2020,150,7796,5580,92,2124
14/11/2020,121,7917,5702,95,2120
15/11/2020,117,8034,5765,97,2172
16/11/2020,103,8137,5888,98,2151
17/11/2020,110,8247,6049,101,2097
18/11/2020,173,8420,6184,103,2133
19/11/2020,140,8560,6301,104,2155
20/11/2020,121,8681,6406,108,2167
21/11/2020,141,8822,6565,111,2146
22/11/2020,102,8924,6654,111,2159
23/11/2020,80,9004,6831,113,2060
24/11/2020,133,9137,6938,117,2082
25/11/2020,116,9253,7062,122,2069
26/11/2020,152,9405,7165,125,2115
27/11/2020,96,9501,7297,128,2076
28/11/2020,108,9609,7418,132,2059
29/11/2020,143,9752,7557,133,2062
30/11/2020,121,9873,7665,137,2071
01/12/2020,102,9975,7748,141,2086
02/12/2020,126,10101,7887,146,2068
03/12/2020,96,10197,8015,148,2034
04/12/2020,123,10320,8120,149,2051
05/12/2020,103,10423,8289,149,1985
06/12/2020,97,10520,8396,151,1985
07/12/2020,139,10659,8497,155,2007
08/12/2020,40,10699,8641,157,1901
09/12/2020,79,10778,8720,160,1898
10/12/2020,106,10884,8848,164,1872
11/12/2020,96,10980,8935,166,1879
12/12/2020,121,11101,9079,166,1856
13/12/2020,52,11153,9169,169,1815
14/12/2020,101,11254,9319,174,1761
15/12/2020,49,11303,9420,177,1706
16/12/2020,112,11415,9516,180,1719
17/12/2020,60,11475,9670,182,1623
18/12/2020,94,11569,9780,183,1606
19/12/2020,52,11621,9881,187,1553
20/12/2020,93,11714,9978,190,1546
21/12/2020,88,11802,10115,194,1493
22/12/2020,108,11910,10161,196,1553
23/12/2020,82,11992,10293,201,1498
24/12/2020,70,12062,10423,203,1436
25/12/2020,50,12112,10547,203,1362
26/12/2020,129,12241,10550,206,1485
27/12/2020,84,12325,10668,210,1447
28/12/2020,101,12426,10791,215,1420
29/12/2020,115,12541,10919,215,1407
30/12/2020,124,12665,11057,216,1392
31/12/2020,109,12774,11121,219,1434
01/01/2021,135,12909,11178,219,1512
02/01/2021,88,12997,11211,220,1566
03/01/2021,85,13082,11275,220,1587
04/01/2021,148,13230,11386,222,1622
05/01/2021,158,13388,11460,226,1702
06/01/2021,224,13612,11540,227,1845
07/01/2021,164,13776,11613,228,1935
08/01/2021,191,13967,11690,230,2047
09/01/2021,245,14212,11759,232,2221
10/01/2021,184,14396,11841,233,2322
11/01/2021,133,14529,11936,233,2360
12/01/2021,240,14769,12016,234,2519
13/01/2021,189,14958,12123,234,2601
14/01/2021,121,15079,12250,235,2594
15/01/2021,193,15272,12393,236,2643
16/01/2021,175,15447,12460,238,2749
17/01/2021,141,15588,12596,239,2753
18/01/2021,154,15742,12717,241,2784
19/01/2021,200,15942,12865,242,2835
20/01/2021,187,16129,13054,244,2831
21/01/2021,151,16280,13234,245,2801
22/01/2021,143,16423,13435,248,2740
23/01/2021,119,16542,13646,250,2646
24/01/2021,116,16658,13801,251,2606
25/01/2021,203,16861,13976,253,2632
26/01/2021,138,16999,14104,255,2640
27/01/2021,193,17192,14252,258,2682
28/01/2021,208,17400,14452,261,2687
29/01/2021,185,17585,14626,264,2695
30/01/2021,136,17721,14775,265,2681
31/01/2021,182,17903,14960,267,2676
01/02/2021,124,18027,15101,269,2657
02/02/2021,141,18168,15233,270,2665
03/02/2021,138,18306,15423,273,2610
04/02/2021,79,18385,15567,273,2545
05/02/2021,57,18442,15701,277,2464
06/02/2021,134,18576,15896,279,2401
07/02/2021,100,18676,16053,282,2341
08/02/2021,137,18813,16179,282,2352
09/02/2021,202,19015,16325,284,2406
10/02/2021,167,19182,16490,286,2406
11/02/2021,151,19333,16646,286,2401
12/02/2021,164,19497,16811,288,2398
13/02/2021,154,19651,17017,290,2344
14/02/2021,138,19789,17126,293,2370
15/02/2021,156,19945,17310,295,2340
16/02/2021,102,20047,17434,297,2316
17/02/2021,199,20246,17523,298,2425
18/02/2021,163,20409,17679,301,2429
19/02/2021,154,20563,17827,301,2435
20/02/2021,199,20762,17933,303,2526
21/02/2021,130,20892,18067,304,2521
22/02/2021,193,21085,18309,305,2471
23/02/2021,221,21306,18500,306,2500
24/02/2021,226,21532,18720,308,2504
25/02/2021,192,21724,18905,311,2508
26/02/2021,258,21982,19087,313,2582
27/02/2021,237,22219,19255,313,2651
28/02/2021,263,22482,19447,315,2720
01/03/2021,175,22657,19663,316,2678
02/03/2021,336,22993,19743,319,2931
03/03/2021,233,23226,19905,321,3000
04/03/2021,362,23588,20135,325,3128
05/03/2021,283,23871,20291,328,3252
06/03/2021,345,24216,20484,329,3403
07/03/2021,182,24398,20742,334,3322
08/03/2021,201,24599,21087,334,3178
09/03/2021,248,24847,21477,335,3035
10/03/2021,510,25357,21838,337,3182
11/03/2021,283,25640,22176,341,3123
12/03/2021,329,25969,22435,346,3188
13/03/2021,298,26267,22773,350,3144
14/03/2021,268,26535,23060,351,3124
15/03/2021,213,26748,23376,354,3018
16/03/2021,313,27061,23591,357,3113
17/03/2021,211,27272,23784,361,3127
18/03/2021,243,27515,24118,363,3034
19/03/2021,179,27694,24432,364,2898
20/03/2021,210,27904,24662,369,2873
21/03/2021,224,28128,25020,372,2736
22/03/2021,191,28319,25343,373,2603
23/03/2021,90,28409,25555,375,2479
24/03/2021,101,28510,25857,377,2276
25/03/2021,102,28612,26148,378,2086
26/03/2021,103,28715,26480,382,1853
27/03/2021,93,28808,26763,385,1660
28/03/2021,67,28875,27086,387,1402
29/03/2021,63,28938,27418,388,1132
30/03/2021,55,28993,27704,390,899
31/03/2021,40,29033,27805,392,836
01/04/2021,52,29085,27951,394,740
02/04/2021,42,29127,28045,395,687
03/04/2021,62,29189,28159,397,633
04/04/2021,34,29223,28276,398,549
05/04/2021,56,29279,28349,399,531
06/04/2021,64,29343,28416,399,528
07/04/2021,65,29408,28463,400,545
08/04/2021,55,29463,28508,401,554
09/04/2021,48,29511,28561,401,549
10/04/2021,37,29548,28610,402,536
11/04/2021,66,29614,28654,402,558
12/04/2021,47,29661,28706,402,553
13/04/2021,59,29720,28756,403,561
14/04/2021,58,29778,28797,403,578
15/04/2021,55,29833,28842,403,588
16/04/2021,27,29860,28872,405,583
17/04/2021,67,29927,28910,409,608
18/04/2021,39,29966,28962,409,595
19/04/2021,60,30026,29003,409,614
20/04/2021,13,30039,29065,411,563
21/04/2021,24,30063,29130,411,522
22/04/2021,33,30096,29166,411,519
23/04/2021,33,30129,29204,412,513
24/04/2021,20,30149,29261,412,476
25/04/2021,25,30174,29296,413,465
26/04/2021,15,30189,29354,413,422
27/04/2021,45,30234,29421,413,400
28/04/2021,15,30249,29462,413,374
29/04/2021,27,30276,29493,413,370
30/04/2021,16,30292,29548,413,331
01/05/2021,15,30307,29622,415,270
02/05/2021,12,30319,29642,416,261
03/05/2021,35,30354,29658,416,280
04/05/2021,27,30381,29677,416,288
05/05/2021,30,30411,29715,416,280
06/05/2021,9,30420,29744,416,260
07/05/2021,12,30432,29763,417,252
08/05/2021,6,30438,29774,417,247
09/05/2021,9,30447,29805,417,225
10/05/2021,11,30458,29828,417,213
11/05/2021,6,30464,29843,417,204
12/05/2021,5,30469,29860,417,192
13/05/2021,4,30473,29867,417,189
14/05/2021,1,30474,29877,417,180
15/05/2021,4,30478,29884,417,177
16/05/2021,2,30480,29905,417,158
17/05/2021,4,30484,29920,417,147
18/05/2021,2,30486,29941,417,128
19/05/2021,3,30489,29952,417,120
20/05/2021,2,30491,29974,417,100
21/05/2021,6,30497,29984,417,96
22/05/2021,2,30499,29998,417,84
23/05/2021,5,30504,30006,417,81
24/05/2021,2,30506,30017,417,72
25/05/2021,3,30509,30022,418,69
26/05/2021,7,30516,30028,419,69
27/05/2021,4,30520,30036,419,65
28/05/2021,6,30526,30041,419,66
29/05/2021,3,30529,30043,419,67
30/05/2021,4,30533,30046,419,68
31/05/2021,2,30535,30050,419,66
01/06/2021,8,30543,30054,419,70
02/06/2021,10,30553,30058,419,76
03/06/2021,4,30557,30062,419,76
04/06/2021,2,30559,30066,419,74
05/06/2021,9,30568,30073,419,76
06/06/2021,3,30571,30078,419,74
07/06/2021,0,30571,30080,419,72
08/06/2021,1,30572,30083,419,70
09/06/2021,1,30573,30086,419,68
10/06/2021,4,30577,30091,419,67
11/06/2021,2,30579,30096,419,64
12/06/2021,2,30581,30100,419,62
13/06/2021,0,30581,30103,419,59
14/06/2021,1,30582,30109,419,54
15/06/2021,0,30582,30112,419,51
16/06/2021,3,30585,30121,419,45
17/06/2021,0,30585,30132,420,33
18/06/2021,3,30588,30136,420,32
19/06/2021,0,30588,30139,420,29
20/06/2021,1,30589,30142,420,27
21/06/2021,1,30590,30147,420,23
22/06/2021,5,30595,30148,420,27
23/06/2021,0,30595,30149,420,26
24/06/2021,3,30598,30151,420,27
25/06/2021,5,30603,30154,420,29
26/06/2021,3,30606,30156,420,30
27/06/2021,0,30606,30158,420,28
28/06/2021,6,30612,30158,420,34
29/06/2021,6,30618,30158,420,40
30/06/2021,5,30623,30158,420,45
01/07/2021,4,30627,30161,420,46
02/07/2021,6,30633,30161,420,52
03/07/2021,7,30640,30164,420,56
04/07/2021,12,30652,30164,420,68
05/07/2021,12,30664,30165,420,79
06/07/2021,11,30675,30165,420,90
07/07/2021,25,30700,30170,420,110
08/07/2021,55,30755,30176,420,159
09/07/2021,96,30851,30179,420,252
10/07/2021,109,30960,30181,420,359
11/07/2021,101,31061,30184,420,457
12/07/2021,179,31240,30186,420,634
13/07/2021,154,31394,30192,420,782
14/07/2021,218,31612,30192,420,1000
15/07/2021,222,31834,30202,420,1212
16/07/2021,235,32069,30208,420,1441
17/07/2021,206,32275,30213,420,1642
18/07/2021,195,32470,30218,420,1832
19/07/2021,146,32616,30233,420,1963
20/07/2021,217,32833,30236,420,2177
21/07/2021,199,33032,30266,420,2346
22/07/2021,166,33198,30291,420,2487
23/07/2021,172,33370,30356,420,2497
24/07/2021,171,33541,30448,421,2276
25/07/2021,127,33668,30557,421,2294
26/07/2021,94,33762,30683,421,2262
27/07/2021,142,33904,30857,421,2230
28/07/2021,91,33995,30982,423,2194
29/07/2021,95,34090,31211,423,2060
30/07/2021,111,34201,31410,423,1972
31/07/2021,94,34295,31629,423,1847
01/08/2021,80,34375,31843,423,1713
02/08/2021,64,34439,32011,423,1609
03/08/2021,69,34508,32145,423,1544
04/08/2021,82,34590,32438,423,1333
05/08/2021,78,34668,32642,424,1206
06/08/2021,48,34716,32762,424,1134
07/08/2021,71,34787,32909,424,1058
08/08/2021,59,34846,33079,426,945
09/08/2021,56,34902,33200,428,878
10/08/2021,51,34953,33270,428,859
11/08/2021,87,35040,33407,429,808
12/08/2021,51,35091,33525,429,741
13/08/2021,101,35192,33644,429,723
14/08/2021,94,35286,33764,430,696
15/08/2021,51,35337,33864,430,647
16/08/2021,43,35380,33944,431,609
17/08/2021,54,35434,34001,433,604
18/08/2021,82,35516,34072,433,615
19/08/2021,86,35602,34128,435,643
20/08/2021,51,35653,34181,435,641
21/08/2021,68,35721,34225,436,664
22/08/2021,53,35774,34275,436,667
23/08/2021,57,35831,34312,436,687
24/08/2021,35,35866,34352,437,681
25/08/2021,42,35908,34388,437,687
26/08/2021,42,35950,34447,438,669
27/08/2021,40,35990,34513,439,642
28/08/2021,49,36039,34567,440,636
29/08/2021,50,36089,34618,440,635
30/08/2021,34,36123,34653,440,634
31/08/2021,48,36171,34678,441,656
01/09/2021,76,36247,34727,441,683
02/09/2021,75,36322,34781,441,704
03/09/2021,42,36364,34836,441,691
04/09/2021,62,36426,34869,442,719
05/09/2021,49,36475,34912,444,723
06/09/2021,37,36512,34961,445,710
07/09/2021,41,36553,34990,445,722
08/09/2021,53,36606,35021,446,743
09/09/2021,30,36636,35049,446,745
10/09/2021,38,36674,35092,446,740
11/09/2021,34,36708,35142,447,723
12/09/2021,50,36758,35182,449,731
13/09/2021,35,36793,35225,449,723
14/09/2021,50,36843,35251,449,747
15/09/2021,32,36875,35311,450,718
16/09/2021,25,36900,35356,452,696
17/09/2021,27,36927,35435,453,643
18/09/2021,25,36952,35486,453,617
19/09/2021,20,36972,35537,453,586
20/09/2021,22,36994,35569,455,574
21/09/2021,24,37018,35612,456,554
22/09/2021,18,37036,35661,456,523
23/09/2021,12,37048,35708,456,488
24/09/2021,13,37061,35737,457,471
25/09/2021,16,37077,35781,457,443
26/09/2021,13,37090,35816,457,421
27/09/2021,13,37103,35859,457,391
28/09/2021,16,37119,35896,457,370
29/09/2021,8,37127,35941,457,333
30/09/2021,22,37149,35968,457,328
01/10/2021,14,37163,35998,458,311
02/10/2021,24,37187,36019,459,313
03/10/2021,10,37197,36049,459,293
04/10/2021,24,37221,36072,459,294
05/10/2021,25,37246,36099,459,292
06/10/2021,18,37264,36142,459,267
07/10/2021,19,37283,36157,459,271
08/10/2021,24,37307,36170,459,282
09/10/2021,16,37323,36205,459,263
10/10/2021,24,37347,36211,459,281
11/10/2021,11,37358,36233,459,270
12/10/2021,17,37375,36240,459,280
13/10/2021,18,37393,36253,459,285
14/10/2021,19,37412,36268,459,289
15/10/2021,25,37437,36292,459,290
16/10/2021,8,37445,36311,459,279
17/10/2021,10,37455,36329,459,271
18/10/2021,11,37466,36340,459,271
19/10/2021,22,37488,36361,459,272
20/10/2021,20,37508,36391,459,262
21/10/2021,17,37525,36405,459,265
22/10/2021,10,37535,36428,460,251
23/10/2021,6,37541,36449,460,236
24/10/2021,12,37553,36470,460,227
25/10/2021,13,37566,36491,460,219
26/10/2021,16,37582,36504,460,222
27/10/2021,15,37597,36523,460,218
28/10/2021,15,37612,36536,460,220
29/10/2021,8,37620,36559,461,204
30/10/2021,19,37639,36574,461,208
31/10/2021,16,37655,36583,461,215
01/11/2021,20,37675,36592,461,226
02/11/2021,29,37704,36608,462,238
03/11/2021,34,37738,36629,462,251
04/11/2021,37,37775,36646,462,271
05/11/2021,40,37815,36659,462,298
06/11/2021,41,37856,36667,462,331
07/11/2021,50,37906,36679,462,369
08/11/2021,27,37933,36694,462,381
09/11/2021,35,37968,36704,462,406
10/11/2021,38,38006,36713,462,435
11/11/2021,63,38069,36738,462,473
12/11/2021,50,38119,36748,462,513
13/11/2021,51,38170,36760,462,552
14/11/2021,32,38202,36779,462,565
15/11/2021,55,38257,36796,462,603
16/11/2021,64,38321,36827,462,636
17/11/2021,64,38385,36857,462,670
18/11/2021,66,38451,36889,462,704
19/11/2021,79,38530,36919,462,753
20/11/2021,59,38539,36964,463,766
21/11/2021,122,38711,37005,463,847
22/11/2021,62,38773,37047,464,866
23/11/2021,71,38844,37077,464,907
24/11/2021,86,38930,37116,464,954
25/11/2021,83,39013,37144,466,1007
26/11/2021,56,39069,37202,468,1003
27/11/2021,95,39164,37249,468,1051
28/11/2021,72,39236,37292,468,1080
29/11/2021,95,39331,37331,468,1136
30/11/2021,106,39437,37385,468,1188
01/12/2021,95,39532,37455,468,1213
02/12/2021,138,39670,37516,468,1290
03/12/2021,133,39803,37591,468,1348
04/12/2021,59,39862,37591,468,1347
05/12/2021,69,39931,37774,468,1293
06/12/2021,81,40012,37835,468,1313
07/12/2021,86,40098,37897,468,1337
08/12/2021,87,40185,37958,468,1363
09/12/2021,81,40266,38065,469,1336
10/12/2021,88,40354,38124,470,1364
11/12/2021,111,40465,38191,470,1408
12/12/2021,78,40543,38285,471,1391
13/12/2021,78,40621,38358,471,1396
14/12/2021,100,40721,38448,471,1406
15/12/2021,168,40889,38558,471,1464
16/12/2021,167,41056,38657,471,1532
17/12/2021,221,41277,38810,471,1600
18/12/2021,291,41568,38910,471,1791
19/12/2021,282,41850,38965,471,2018
20/12/2021,252,42102,39045,471,2190
21/12/2021,386,42488,39116,471,2505
22/12/2021,582,43070,39210,473,2991
23/12/2021,733,43803,39302,473,3632
24/12/2021,955,44758,39420,473,4469
25/12/2021,917,45675,39516,474,5289
26/12/2021,572,46247,39610,475,5766
27/12/2021,832,47079,39688,476,6519
28/12/2021,1298,48377,39770,476,7735
29/12/2021,1337,49714,39886,476,8956
30/12/2021,1353,51067,40058,476,10137
31/12/2021,1403,52470,40156,477,11441
01/01/2022,1030,53500,40405,477,12222
02/01/2022,747,54247,40684,479,12688
03/01/2022,812,55059,40924,479,13260
04/01/2022,1147,56206,41209,480,14121
05/01/2022,922,57128,41618,482,14632
06/01/2022,1144,58272,42327,484,15065
07/01/2022,786,59058,43215,485,14962
08/01/2022,762,59820,44322,487,14615
09/01/2022,563,60383,45340,488,14159
10/01/2022,437,60820,45882,489,14053
11/01/2022,432,61252,46750,492,13614
12/01/2022,673,61925,47929,496,13104
13/01/2022,462,62387,49190,500,12301
14/01/2022,516,62903,50445,501,11561
15/01/2022,503,63406,51752,504,10754
16/01/2022,301,63707,52885,506,9920
17/01/2022,288,63995,53584,506,9509
18/01/2022,379,64374,54288,509,9181
19/01/2022,342,64716,54836,514,8970
20/01/2022,286,65002,55388,520,8698
21/01/2022,306,65308,56450,521,7941
22/01/2022,285,65593,57746,525,6926
23/01/2022,273,65866,59177,532,5761
24/01/2022,202,66068,60430,534,4708
25/01/2022,323,66391,60972,536,4487
26/01/2022,314,66705,61462,538,4309
27/01/2022,230,66935,62052,541,3946
28/01/2022,229,67164,62627,544,3597
29/01/2022,190,67354,63068,545,3345
30/01/2022,191,67545,63469,547,3133
31/01/2022,169,67714,63796,550,2972
01/02/2022,249,67963,64062,551,2954
02/02/2022,227,68190,64415,556,2823
03/02/2022,240,68430,64733,559,2742
04/02/2022,214,68644,65013,560,2675
05/02/2022,195,68839,65323,565,2555
06/02/2022,158,68997,65639,569,2393
07/02/2022,175,69172,65875,570,2331
08/02/2022,186,69358,66161,571,2230
09/02/2022,172,69530,66465,572,2097
10/02/2022,118,69648,66735,576,1941
11/02/2022,143,69791,66944,579,1872
12/02/2022,107,69898,67142,585,1775
13/02/2022,116,70014,67349,589,1680
14/02/2022,72,70086,67470,592,1628
15/02/2022,122,70208,67654,593,1565
16/02/2022,117,70325,67955,594,1380
17/02/2022,109,70434,68247,594,1197
18/02/2022,79,70513,68535,594,988
19/02/2022,72,70585,68697,594,898
20/02/2022,77,70662,68854,596,816
21/02/2022,74,70736,68977,598,765
22/02/2022,90,70826,69068,599,763
23/02/2022,79,70905,69164,601,744
24/02/2022,95,71000,69270,601,733
25/02/2022,80,71080,69358,601,725
26/02/2022,96,71176,69453,602,725
27/02/2022,56,71232,69518,604,714
28/02/2022,40,71272,69579,605,692
01/03/2022,86,71358,69643,605,714
02/03/2022,94,71452,69713,606,737
03/03/2022,126,71578,69801,607,774
04/03/2022,98,71676,69873,607,800
05/03/2022,121,71797,69948,608,845
06/03/2022,99,71896,70022,608,870
07/03/2022,72,71968,70102,609,861
08/03/2022,159,72127,70171,610,950
09/03/2022,138,72265,70255,612,1002
10/03/2022,153,72418,70331,613,1078
11/03/2022,139,72557,70399,613,1149
12/03/2022,127,72684,70485,614,1189
13/03/2022,171,72855,70536,614,1309
14/03/2022,143,72998,70574,615,1413
15/03/2022,194,73192,70652,617,1527
16/03/2022,229,73421,70734,618,1673
17/03/2022,304,73725,70849,619,1861
18/03/2022,301,74026,70936,621,2073
19/03/2022,286,74312,71051,621,2244
20/03/2022,203,74515,71141,622,2356
21/03/2022,251,74766,71207,624,2539
22/03/2022,333,75099,71356,624,2723
23/03/2022,375,75474,71483,626,2969
24/03/2022,415,75889,71614,626,3253
25/03/2022,465,76354,71741,627,3590
26/03/2022,392,76746,71856,630,3864
27/03/2022,353,77099,72019,631,4053
28/03/2022,360,77459,72153,634,4276
29/03/2022,603,78062,72346,635,4685
30/03/2022,717,78779,72562,638,5183
31/03/2022,760,79539,72865,638,5640
01/04/2022,659,80198,73194,638,5970
02/04/2022,791,80989,73459,639,6495
03/04/2022,607,81596,73649,641,6910
04/04/2022,530,82126,73898,644,7188
05/04/2022,719,82845,74227,649,7573
06/04/2022,822,83667,74592,650,8029
07/04/2022,731,84398,74993,652,8357
08/04/2022,659,85057,75413,656,8592
09/04/2022,563,85620,75744,659,8821
10/04/2022,542,86162,76061,662,9043
11/04/2022,433,86595,76401,664,9134
12/04/2022,438,87033,76991,667,8979
13/04/2022,408,87441,77693,669,8683
14/04/2022,431,87872,78393,671,8412
15/04/2022,372,88244,79013,672,8163
16/04/2022,314,88558,79743,673,7746
17/04/2022,271,88829,80308,675,7450
18/04/2022,199,89028,80802,677,7153
19/04/2022,282,89310,81503,677,6734
20/04/2022,297,89607,82288,679,6244
21/04/2022,312,89919,82969,684,5870
22/04/2022,249,90168,83521,684,5567
23/04/2022,231,90399,84111,687,5205
24/04/2022,196,90595,84646,688,4865
25/04/2022,178,90773,85151,692,4534
26/04/2022,259,91032,85523,693,4420
27/04/2022,189,91221,85976,696,4153
28/04/2022,206,91427,86356,698,3977
29/04/2022,178,91605,86759,698,3752
30/04/2022,136,91741,87119,698,3528
01/05/2022,120,91861,87343,698,3424
02/05/2022,114,91975,87528,700,3351
03/05/2022,175,92150,87724,702,3328
04/05/2022,158,92308,87926,703,3283
05/05/2022,167,92475,88213,708,3158
06/05/2022,122,92597,88498,708,2995
07/05/2022,132,92729,88728,708,2897
08/05/2022,119,92848,88918,709,2825
09/05/2022,70,92918,89106,711,2705
10/05/2022,123,93041,89273,713,2659
11/05/2022,108,93149,89464,713,2576
12/05/2022,100,93249,89625,713,2515
13/05/2022,111,93360,89807,713,2444
14/05/2022,86,93446,89952,713,2385
15/05/2022,62,93508,90076,713,2323
16/05/2022,64,93572,90182,713,2281
17/05/2022,110,93682,90338,714,2234
18/05/2022,76,93758,90498,716,2148
19/05/2022,85,93843,90649,716,2082
20/05/2022,69,93912,90785,716,2015
21/05/2022,73,93985,90952,717,1920
22/05/2022,61,94046,91098,717,1835
23/05/2022,67,94113,91240,718,1759
24/05/2022,92,94205,91398,719,1692
25/05/2022,59,94264,91540,719,1609
26/05/2022,90,94354,91683,719,1556
27/05/2022,86,94440,91824,719,1501
28/05/2022,73,94513,91946,719,1452
29/05/2022,66,94579,92043,721,1419
30/05/2022,64,94643,92106,721,1420
31/05/2022,99,94742,92215,721,1410
01/06/2022,115,94857,92310,721,1430
02/06/2022,93,94950,92408,722,1424
03/06/2022,118,95068,92512,722,1438
04/06/2022,76,95144,92603,722,1423
05/06/2022,66,95210,92699,723,1392
06/06/2022,62,95272,92759,723,1394
07/06/2022,93,95365,92857,723,1389
08/06/2022,102,95467,92961,723,1387
09/06/2022,175,95642,93060,723,1463
10/06/2022,187,95829,93162,723,1548
11/06/2022,166,95995,93260,724,1615
12/06/2022,153,96148,93339,726,1687
13/06/2022,142,96290,93412,727,1755
14/06/2022,200,96490,93513,728,1853
15/06/2022,273,96763,93627,728,2012
16/06/2022,255,97018,93730,728,2164
17/06/2022,260,97278,93838,728,2316
18/06/2022,279,97557,93964,730,2467
19/06/2022,315,97872,94026,730,2720
20/06/2022,233,98105,94098,730,2881
21/06/2022,488,98593,94167,735,3295
22/06/2022,523,99116,94265,736,3719
23/06/2022,543,99659,94444,738,4081
24/06/2022,479,100138,94624,740,4378
25/06/2022,456,100594,94792,740,4666
26/06/2022,442,101036,94948,740,4952
27/06/2022,417,101453,95110,740,5207
28/06/2022,570,102023,95265,740,5622
29/06/2022,570,102593,95499,740,5958
30/06/2022,539,103132,95764,741,6231
01/07/2022,704,103836,96030,744,6666
02/07/2022,583,104419,96309,747,6967
03/07/2022,500,104919,96614,748,7161
04/07/2022,488,105407,96889,748,7374
05/07/2022,661,106068,97140,751,7781
06/07/2022,614,106682,97689,752,7845
07/07/2022,624,107306,98216,753,7941
08/07/2022,506,107812,98723,754,7939
09/07/2022,471,108283,99241,756,7890
10/07/2022,405,108688,99671,759,7862
11/07/2022,355,109043,100121,762,7764
12/07/2022,450,109493,100587,763,7747
13/07/2022,418,109911,101188,766,7561
14/07/2022,280,110191,101772,768,7255
15/07/2022,310,110501,102409,768,6928
16/07/2022,242,110743,102990,772,6585
17/07/2022,224,110967,103488,772,6311
18/07/2022,182,111149,103974,773,6006
19/07/2022,261,111410,104578,777,5659
20/07/2022,219,111629,105227,778,5228
21/07/2022,204,111833,105872,780,4785
22/07/2022,150,111983,106409,783,4395
23/07/2022,106,112089,106878,785,4030
24/07/2022,128,112217,107323,785,3713
25/07/2022,78,112295,107765,786,3348
26/07/2022,141,112436,108171,787,3082
27/07/2022,97,112533,108667,789,2681
28/07/2022,98,112631,109046,792,2397
29/07/2022,88,112719,109363,792,2168
30/07/2022,51,112770,109641,793,1940
31/07/2022,58,112828,109863,794,1775
01/08/2022,51,112879,110064,794,1625
02/08/2022,94,112973,110279,794,1504
03/08/2022,83,113056,110522,795,1343
04/08/2022,64,113120,110728,795,1201
05/08/2022,50,113170,110900,795,1079
06/08/2022,50,113220,111004,795,1025
07/08/2022,26,113246,111118,795,937
08/08/2022,42,113288,111240,795,857
09/08/2022,47,113335,111344,796,799
10/08/2022,43,113378,111489,797,696
11/08/2022,49,113427,111609,797,625
12/08/2022,44,113471,111708,797,570
13/08/2022,30,113501,111784,797,524
14/08/2022,33,113534,111834,797,507
15/08/2022,24,113558,111888,797,477
16/08/2022,27,113585,111950,797,442
17/08/2022,42,113627,112053,798,380
18/08/2022,66,113693,112130,798,369
19/08/2022,28,113721,112215,799,311
20/08/2022,56,113777,112303,799,279
21/08/2022,23,113800,112347,799,258
22/08/2022,33,113833,112386,799,252
23/08/2022,37,113870,112428,799,247
24/08/2022,22,113892,112480,799,217
25/08/2022,24,113916,112524,799,197
26/08/2022,35,113951,112585,800,170
27/08/2022,21,113972,112621,801,154
28/08/2022,17,113989,112647,801,145
29/08/2022,11,114000,112673,801,130
30/08/2022,26,114026,112700,801,129
31/08/2022,24,114050,112726,801,127
01/09/2022,25,114075,112754,801,124
02/09/2022,22,114097,112783,801,117
03/09/2022,17,114114,112806,801,111
04/09/2022,21,114135,112832,802,105
05/09/2022,16,114151,112855,802,98
06/09/2022,21,114172,112879,802,95
07/09/2022,23,114195,112904,802,93
08/09/2022,11,114206,112917,802,91
09/09/2022,22,114228,112940,802,90
10/09/2022,23,114251,112953,802,100
11/09/2022,14,114265,112964,802,103
12/09/2022,18,114283,112973,803,111
13/09/2022,21,114304,112987,803,118
14/09/2022,19,114323,113002,803,122
15/09/2022,25,114348,113019,803,130
16/09/2022,20,114368,113035,803,134
17/09/2022,24,114392,113045,803,148
18/09/2022,19,114411,113054,804,157
19/09/2022,14,114425,113066,804,159
20/09/2022,18,114443,113077,804,166
21/09/2022,27,114470,113088,804,182
22/09/2022,33,114503,113107,804,196
23/09/2022,31,114534,113122,804,212
24/09/2022,16,114550,113132,804,218
25/09/2022,17,114567,113145,804,222
26/09/2022,16,114583,113154,804,229
27/09/2022,22,114605,113168,804,237
28/09/2022,23,114628,113180,806,246
29/09/2022,24,114652,113195,806,255
30/09/2022,40,114692,113215,806,275
01/10/2022,18,114710,113229,806,279
02/10/2022,9,114719,113246,806,271
03/10/2022,11,114730,113262,806,266
04/10/2022,27,114757,113277,806,278
05/10/2022,20,114777,113298,806,277
06/10/2022,28,114805,113323,806,280
07/10/2022,17,114822,113344,806,276
08/10/2022,17,114839,113364,806,273
09/10/2022,27,114866,113377,806,287
10/10/2022,21,114887,113391,806,294
11/10/2022,23,114910,113403,806,305
12/10/2022,8,114918,113422,806,294
13/10/2022,23,114941,113445,806,294
14/10/2022,22,114963,113475,806,286
15/10/2022,22,114985,113495,806,288
16/10/2022,28,115013,113504,806,307
17/10/2022,23,115036,113514,806,320
18/10/2022,36,115072,113532,806,338
19/10/2022,31,115103,113556,806,345
20/10/2022,33,115136,113578,807,355
21/10/2022,23,115159,113602,807,354
22/10/2022,17,115176,113619,808,353
23/10/2022,21,115197,113644,808,349
24/10/2022,18,115215,113668,808,343
25/10/2022,28,115243,113690,808,349
26/10/2022,28,115271,113705,808,362
27/10/2022,23,115294,113716,808,374
28/10/2022,13,115307,113741,808,362
29/10/2022,16,115323,113764,808,355
30/10/2022,15,115338,113783,808,351
31/10/2022,11,115349,113809,808,336
01/11/2022,23,115372,113839,808,329
02/11/2022,30,115402,113874,808,324
03/11/2022,23,115425,113901,808,320
04/11/2022,22,115447,113927,808,316
05/11/2022,12,115459,113949,808,306
06/11/2022,10,115469,113974,808,291
07/11/2022,20,115489,113992,808,293
08/11/2022,23,115512,114014,808,294
09/11/2022,20,115532,114043,808,285
10/11/2022,15,115547,114071,808,272
11/11/2022,16,115563,114088,808,271
12/11/2022,24,115587,114105,808,278
13/11/2022,10,115597,114120,808,273
14/11/2022,11,115608,114133,808,271
15/11/2022,21,115629,114151,808,274
16/11/2022,12,115641,114176,808,261
17/11/2022,19,115660,114201,808,255
18/11/2022,13,115673,114224,808,245
19/11/2022,8,115681,114242,808,235
20/11/2022,14,115695,114256,808,235
21/11/2022,8,115703,114274,808,225
22/11/2022,18,115721,114299,808,218
23/11/2022,13,115734,114319,809,210
24/11/2022,16,115750,114338,809,207
25/11/2022,4,115754,114353,809,196
26/11/2022,11,115765,114372,809,188
27/11/2022,4,115769,114389,809,175
28/11/2022,6,115775,114399,809,171
29/11/2022,15,115790,114415,809,170
30/11/2022,28,115818,114433,809,180
01/11/2022,21,115839,114444,809,190
02/12/2022,12,115851,114468,809,178
03/12/2022,6,115857,114479,809,173
04/12/2022,13,115870,114487,809,178
05/12/2022,21,115891,114499,809,187
06/12/2022,16,115907,114518,809,184
07/12/2022,11,115918,114531,809,182
08/12/2022,15,115933,114545,809,183
09/12/2022,8,115941,114560,809,176
10/12/2022,19,115960,114569,809,186
11/12/2022,13,115973,114576,809,192
12/12/2022,8,115981,114581,809,195
13/12/2022,19,116000,114586,809,209
14/12/2022,28,116028,114603,811,218
15/12/2022,31,116059,114628,811,224
16/12/2022,23,116082,114639,811,236
17/12/2022,11,116093,114652,811,234
18/12/2022,21,116114,114657,811,250
19/12/2022,13,116127,114673,811,247
20/12/2022,25,116152,114696,811,249
21/12/2022,25,116177,114712,811,258
22/12/2022,19,116196,114725,812,263
23/12/2022,16,116212,114737,813,266
24/12/2022,19,116231,114746,813,276
25/12/2022,16,116247,114763,813,275
26/12/2022,6,116253,114773,813,271
27/12/2022,27,116280,114787,813,284
28/12/2022,23,116303,114814,813,280
29/12/2022,17,116320,114844,813,267
30/12/2022,36,116356,114871,815,274
31/12/2022,28,116384,114889,815,284
01/01/2023,30,116414,114902,817,299
